LHT-1-EN-DE
LHT Vokabeln 1 (englisch-deutsch)
DE
to bother::stören, nerven
pension fund::die Betriebsrente
to bribe::bestechen
to pretend::so tun als ob
ingredients::die Zutaten
stressful::stressig
to interrupt::unterbrechen
lazy::faul
area code::die Vorwahl
apology::die Entschuldigung
occupation::der Beruf
recipient::der Empfänger
to commute::pendeln
a rehearsal::die Probe
to comply with::folgen, beachten
apprenticeship::die Lehre
to spend money on::Geld ausgeben für
core business::das Kerngeschäft
a caretaker::der Hausmeister
reputation::der Ruf
chairperson::der Vorsitzender
a job interview::das Vorstellungsgespräch
a farewell party::die Abschiedsfete
carpenter::der Zimmermann
niece::die Nichte
nephew::der Neffe
an only child::das Einzelkind
a draw or tie::untentschieden
to clock out::ausstempeln
agenda::die Agenda
participants::der Teilnehmer
to expire::auslaufen
nosey, curious::neugierig
a workman, tradesman::der Handwerker
hiking::wandern
to move house::umziehen
threatening::bedrohlich
landmark::das Wahrzeichen
a white lie::die Notlüge
inconvenience::die Unannehmlichkeiten
to sum it  up::zusammenfassen
to treat somebody::jmdn einladen
at short notice::kurzfristig
to attend::besuchen
destination::das Ziel
possibilities::die Möglichkeiten
to do the cover for::jmdn vertreten
a method of transport::das Verkehrsmittel
archery::das Bogenschiessen
due, overdue::fällig
vegetables::das Gemüse
grateful::dankbar
roast potatoes::die Bratkartoffeln
to take the minutes::Protokoll führen
target group::die Zielgruppe
cuisine::die Küche
to have an argument::einen Streit haben
a valued customer::geschätzter Kunde
surrounding area::die Umgebung
parents-in-law::die Schwiegereltern
champagne reception::der Sektempfang
a lie::die Lüge
satisfied::zufrieden

