LHT-1-DE-EN
LHT Vokabeln 1 (deutsch-englisch)
EN
stören, nerven::to bother
die Betriebsrente::pension fund
bestechen::to bribe
so tun als ob::to pretend
die Zutaten::ingredients
stressig::stressful
unterbrechen::to interrupt
faul::lazy
Vorwahl::area code
die Entschuldigung::apology
der Beruf::occupation
der Empfänger::recipient
pendeln::to commute
die Probe::a rehearsal
folgen, beachten::to comply with
die Lehre::apprenticeship
Geld ausgeben für::to spend money on
das Kerngeschäft::core business
der Hausmeister::a caretaker
der Ruf::reputation
der Vorsitzende::chairperson
das Vorstellungsgespräch::a job interview
die Abschiedsfete::a farewell party
der Zimmermann::carpenter
die Nichte::niece
der Neffe::nephew
das Einzelkind::an only child
untentschieden::a draw or tie
ausstempeln::to clock out
die Agenda::agenda
der Teilnehmer::participants
auslaufen::to expire
neugierig::nosey, curious
der Handwerker::a workman, tradesman
wandern::hiking
umziehen::to move house
bedrohlich::threatening
das Wahrzeichen::landmark
die Notlüge::a white lie
die Unannehmlichkeiten::inconvenience
zusammenfassen::to sum it  up
jmdn einladen::to treat somebody
kurzfristig::at short notice
besuchen::to attend
das Ziel::destination
Möglichkeiten::possibilities
jmdn vertreten::to do the cover for
das Verkehrsmittel::a method of transport
das Bogenschiessen::archery
fällig::due, overdue
das Gemüse::vegetables
dankbar::grateful
die Bratkartoffeln::roast potatoes
Protokoll führen::to take the minutes
die Zielgruppe::target group
die Küche::cuisine
einen Streit haben::to have an argument
geschätzter Kunde::a valued customer
die Umgebung::surrounding area
die Schwiegereltern::parents-in-law
der Sektempfang::champagne reception
die Lüge::a lie
zufrieden::satisfied
