please permit me to give you some background ::Hintergrundinformation geben
to have in mind::im Sinn haben
sorry to be a whine::
I am sure you appreciate::ich bin mir sicher, dass Du es begrüßen wirst
I am doing this because::ich tue es aus diesem Grund
I am trying to help you get what you want::ich helfe Dir das zu bekommen was Du möchtest
I appreciate your concern and agree wholeheardly with your points::
speak now or forever hold you peace::Sprich jetzt oder schweige für immer
to get the wheels turning::mit etwas loslegen
to be crushed by my new workload::mit der neuen Arbeit überfordert sein
OK  I am onto this::OK ich bin dran
pick it up with someone and get back to::Nimm es auf mit jemanden und komme dann darauf zurück
never seen before::einmalig
breathtaking::überwältigend
heart bumping::
brilliant::brilliant
amazing::unglaublich
create talk ability::für Gesprächsstoff sorgen
money can not buy::unbezahlbar
excellent::außerordentlich
ignite a craze::
phenomenon::Phenomen
higher purpose::höherer Sinn
to fuel competition::den Wettbewerb anheizen
keeping score::sich vergleichen
every touch counts::alles zählt
think the idea not the maths::
to put it into a nutshell::kurz zusammenfassen
cut a long story short::zusammenfassen
court in their own guile::sich selber austricksen
I have not got a pot to piss in::nicht mehr haben
full of himself::selbsteingenommen sein
tough cookie::starke Persönlichkeit
trod on a few heads::über Leichen gehen
walking over dead bodies::über Leichen gehen
sell his own grandmother::die eigene Großmutter verkaufen
you are the company you keep::Du bist derjenige mit denen Du dich umgibst
plans are made to be broken::
once bitten twice shy::nächstes mal besser aufpassen
let sleeping dogs lay::schlafende Hunde soll man nicht wecken
be down in the dumps::niedergeschlagen sein
rolls of the tongue::ist einem so rausgerutscht
it is a resounding no::ein absolutes nein zu etwas
on the tip of ma tongue::liegt einem auf der Zunge
a opportunity is never missed it is just picked up be someone else::eine Chance ist nie verloren, weil sie immer jemand anderes nutzen wird
tend to rubbish::alles schlecht machen
paint morbid picture::
top-heavy::zu viele Häuptlinge und keine Indianer
take the bull by the horns::eine Sache direkt angehen
face the problem::
pride becomes before the crash::Hochmut kommt vor dem Fall
be on the same wavelength::auf einer Wellelänge sein
hear it on the grapevine::die Buschtrommeln hören
beating around the bush::um den heißen Brei reden
get a word in edgeways::
have a quick word::lass und kurz sprechen
talking at cross purpose::aneinander vorbeireden
to put someone in the picture::jemanden einen Überblick verschaffen
it is like talking to a brick wall::gegen die Wand reden
do not rock the boot::die Situation nicht noch schlechter machen
do not spoil the party::
hear something from the horse's mouth::von jemanden betroffenen hören
everything that can be said can be said clearly::etwas klar und direkt ausdrücken
to keep under your hat::verstecken, geheim halten
I can not be bothered::
bark up someone else's tree::jemanden anderen damit nerven
the train has already left the station::der Zug ist abgefahren
put your skates on::ran an die arbeit
burning the candle on both ends::man kann nicht zwei Dinge  gleichzeitig tun
double edge sword::zweischneidiges Schwert
it goes without saying::unausgesprochen
anything but boring::alles andere als langweilig
break through effort::entscheidende Bemühung / Einsatz  
your lucky bread::
to pick up the tag::Verantwortung übernehmen
try to make yourself look good on the expenses of others::sich auf Kosten anderer in ein gutes Licht setzten
itchy feed::Fernweh
fits like a glove::passt perfekt
pretty much good::ziemlich gut
how do we get the gloves of::aggressiver werden
stuck in the glue::
be bang on::
be in the zone::sehr stark involviert sein
from good to great::den entscheidenden Unterschied machen
cut through::
attention grabbing::Aufmerksamkeit auf sich ziehen
to lead someone down the garden path::jemanden führen
take your blinkers of::toleranter, aufgeschlossener sein
movers and shakers::Prominente
be in the driving seat::Verantwortung übernehmen
not firing all cylinders::nicht voll dabei sein
swing and round about::etwas gleicht sich aus
be on the property ladder::sich Eigentum anschaffen
to fill someone's time::
a lack of::es fehlt an
with due respect::mit allem Respekt
would like to give you some honest feedback::ehrliches Feedback geben
discussed at our last meeting::wie besprochen an unserem letzten Meeting
slight amendment::kleine Anmerkung
all good relationships must come to an end at some point::alle guten Beziehungen gehen einmal zu Ende
running out of time::aus der Zeit laufen
to wait in the wings::in den Startlöchern sein
to hail something::etwas freudig begrüßen
fiscal purgatory::Finanzbereiniung
to cook the book::Bücher / Zahlen manipulieren
to take it's toll::seinen Tribut fordern
to box itself in with::zu viele Ziele setzten
show Dutch courage::keinen großen Mut zeigen
pissing down their backs and telling them it is raining::was vom Pferd erzählen
cut the crap::lass mal das herumalbern
do not give me that bullshit::lass mich in Ruhe damit
sorry I do not understand a world you are saying::ich verstehe nur Bahnhof
go and fuck yourself::Fick Dich ins Knie
daft Minnie::dumme Pute
moron idiot::dumme Nuss
yellow belly::feiger Hund
bigmouth::Klugscheißer
lousy game::Scheißspiel
that pisses me off::das stinkt mir
old bag::eine Alte
you are full of shit ::Du hast doch den Arsch offen
kiss my ass::leck mich am Arsch
to be pissed::betrunken sein
the proof of the pudding is in the tasting::man muss es testen bevor man urteilt
to take the piss out of someone::sich über jemanden lustig machen
to be dear to one's heart::jemanden am Herzen liegen
to give a shit on something::einem etwas egal sein
pick up where they left of::jemanden dort abholen wo man ihn hat stehen lassen
to place emphasis on something::Akzent auf etwas setzten
continuing competitive superiority::kontinuierliche wettbewerbliche Überlegenheit
to keep someone in the loop::jemanden auf dem laufenden halten
to keep in touch with someone::mit jemanden im Kontakt bleiben
pompous ass::Wichtigtuer


get your head around it::akzeptiere es
go where the guys are::dahin gehen wo die Menschen sind
Joe bloggs ::Durchschnittsbürger
Having said that::wie gesagt
can not teach a old dog new tricks::vergeblich jemanden verändern wollen
the challenge now is to land it::die Herausforderung liegt darin es jetzt zu starten
from good to great::
attention grabbing::aufmerksamkeitsstark
by end of play today::am Ende des Tages
you missing out::etwas verpassen
to feel under the weather::sich unwohl fühlen
barking up the wrong tree::seine Zeit verschwenden mit etwas
make a move::losgehen
someone is on the make::jemand ist unehrlich
someone is on the game::jemand prostituiert sich
to make a meal out of::eine große Sache daraus machen, aufblasen
as daft as a brush::sehr dämlich sein
someone takes the biscuit::jemand tut etwas sehr doofes
your are a pain in the neck::du bist eine anstrengende person
be over the moon::extrem glücklich sein
feel down in the dumps::sehr deprimiert sein
be in the red::Schulden haben
hit the sack::ins Bett gehen
kid's stuff::kinderleicht
stay mum::nichts weitersagen
odds and ends::Stückchen für Stückchen
be up to it::bereit sein für
be in a fix::in einer unangenehmen Lage sein
hold your tongue::den Mund halten
pie in the sky::unrealistisches Versprechen 
drop in the ocean::ein Tropfen auf dem heißen Stein
enough on my plate::zu viel zu tun
shot in the dark::wilde Vermutung
fly off the handle::die Fassung verlieren
talking at cross purposes::aneinander vorbeireden
put you in the picture::die Situation erklären
you can not have your cake and eat it::entweder oder
going down sideroads::Nebenkriegschauplätze aufmachen
party puper::Spaßverderber
working like a dog::sehr hart arbeiten
