IDIOMS-DE-EN
Idiomatische Redewendungen DE-EN
EN
aggressiver werden::how do we get the gloves of
Akzent auf etwas setzten::to place emphasis on something
alle guten Beziehungen gehen einmal zu Ende::all good relationships must come to an end at some point
alles andere als langweilig::anything but boring
alles schlecht machen::tend to rubbish
alles zählt::every touch counts
aneinander vorbeireden::talking at cross purpose
auf einer Wellel�nge sein::be on the same wavelength
Aufmerksamkeit auf sich ziehen::attention grabbing
aus der Zeit laufen::running out of time
aus�erordentlich::excellent
betrunken sein::to be pissed
brilliant::brilliant
B�cher / Zahlen manipulieren::to cook the book
das stinkt mir::that pisses me off
den entscheidenden Unterschied machen::from good to great
den Wettbewerb anheizen::to fuel competition
der Zug ist abgefahren::the train has already left the station
die Buschtrommeln hören::hear it on the grapevine
die eigene Großmutter verkaufen::sell his own grandmother
die Situation nicht noch schlechter machen::do not rock the boot
Du bist derjenige mit denen Du dich umgibst::you are the company you keep
Du hast doch den Arsch offen::you are full of shit 
dumme Nuss::moron idiot
dumme Pute::daft Minnie
ehrliches Feedback geben::would like to give you some honest feedback
ein absolutes nein zu etwas::it is a resounding no
eine Alte::old bag
eine Chance ist nie verloren, weil sie immer jemand anderes nutzen wird::a opportunity is never missed it is just picked up be someone else
eine Sache direkt angehen::take the bull by the horns
einem etwas egal sein::to give a shit on something
einmalig::never seen before
entscheidende Bemühung / Einsatz  ::break through effort
es fehlt an::a lack of
etwas freudig begrüßen::to hail something
etwas gleicht sich aus::swing and round about
etwas klar und direkt ausdr�cken::everything that can be said can be said clearly
feiger Hund::yellow belly
Fernweh::itchy feed
Fick Dich ins Knie::go and fuck yourself
Finanzbereiniung::fiscal purgatory
f�r Gespr�chsstoff sorgen::create talk ability
gegen die Wand reden::it is like talking to a brick wall
Hintergrundinformation geben::please permit me to give you some background 
Hochmut kommt vor dem Fall::pride becomes before the crash
h�herern Sinn::higher purpose
ich bin mir sicher, dass Du es begr��en wirst::I am sure you appreciate
ich helfe Dir das zu bekommen was Du m�chtest::I am trying to help you get what you want
ich tue es aus diesem Grund::I am doing this because
ich verstehe nur Bahnhof::sorry I do not understand a world you are saying
im Sinn haben::to have in mind
in den Startlöchern sein::to wait in the wings
ist einem so rausgerutscht::rolls of the tongue
jemanden am Herzen liegen::to be dear to one's heart
jemanden anderen damit nerven::bark up someone else's tree
jemanden auf dem laufenden halten::to keep someone in the loop
jemanden dort abholen wo man ihn hat stehen lassen::pick up where they left of
jemanden einen �berblick verschaffen::to put someone in the picture
jemanden f�hren::to lead someone down the garden path
keinen gro�en Mut zeigen::show Dutch courage
kleine Anmerkung::slight amendment
Klugschei�er::bigmouth
kontinuierliche wettbewerbliche �berlegenheit::continuing competitive superiority
kurz zusammenfassen::to put it into a nutshell
lass mal das herumalbern::cut the crap
lass mich in Ruhe damit::do not give me that bullshit
lass und kurz sprechen::have a quick word
leck mich am Arsch::kiss my ass
liegt einem auf der Zunge::on the tip of ma tongue
man kann nicht zwei Dinge  gleichzeitig tun::burning the candle on both ends
man muss es testen bevor man urteilt::the proof of the pudding is in the tasting
mit allem Respekt::with due respect
mit der neuen Arbeit �berfordert sein::to be crushed by my new workload
mit etwas loslegen::to get the wheels turning
mit jemanden im Kontakt bleiben::to keep in touch with someone
n�chstes mal besser aufpassen::once bitten twice shy
nicht mehr haben::I have not got a pot to piss in
nicht voll dabei sein::not firing all cylinders
niedergeschlagen sein::be down in the dumps
Nimm es auf mit jemanden und komme dann darauf zur�ck::pick it up with someone and get back to
OK ich bin dran::OK  I am onto this
passt perfekt::fits like a glove
Phenomen::phenomenon
Prominente::movers and shakers
ran an die arbeit::put your skates on
Schei�spiel::lousy game
schlafende Hunde soll man nicht wecken::let sleeping dogs lay
sehr stark involviert sein::be in the zone
seinen Tribut fordern::to take it's toll
selbsteingenommen sein::full of himself
sich auf Kosten anderer in ein gutes Licht setzten::try to make yourself look good on the expenses of others
sich Eigentum anschaffen::be on the property ladder
sich selber austricksen::court in their own guile
sich �ber jemanden lustig machen::to take the piss out of someone
sich vergleichen::keeping score
Sprich jetzt oder schweige f�r immer::speak now or forever hold you peace
starke Pers�nlichkeit::tough cookie
toleranter, aufgeschlossener sein::take your blinkers of
�ber Leichen gehen::trod on a few heads
�ber Leichen gehen::walking over dead bodies
�berw�ltigend::breathtaking
um den hei�en Brei reden::beating around the bush
unausgesprochen::it goes without saying
unbezahlbar::money can not buy
unglaublich::amazing
Verantwortung �bernehmen::to pick up the tag
Verantwortung �bernehmen::be in the driving seat
verstecken, geheim halten::to keep under your hat
von jemanden betroffenen h�ren::hear something from the horse's mouth
was vom Pferd erz�hlen::pissing down their backs and telling them it is raining
Wichtigtuer::pompous ass
wie besprochen an unserem letzten Meeting::discussed at our last meeting
ziemlich gut::pretty much good
zu viele H�uptlinge und keine Indianer::top-heavy
zu viele Ziele setzten::to box itself in with
zusammenfassen::cut a long story short
zweischneidiges Schwert::double edge sword
akzeptiere es::get your head around it
dahin gehen wo die Menschen sind::go where the guys are
Durchschnittsb�rger::Joe bloggs 
wie gesagt::Having said that
vergeblich jemanden ver�ndern wollen::can not teach a old dog new tricks
die Herausforderung liegt darin es jetzt zu starten::the challenge now is to land it
aufmerksamkeitsstark::attention grabbing
am Ende des Tages::by end of play today
etwas verpassen::you missing out
sich unwohl f�hlen::to feel under the weather
seine Zeit verschwenden mit etwas::barking up the wrong tree
losgehen::make a move
jemand ist unehrlich::someone is on the make
jemand prostituiert sich::someone is on the game
eine gro�e Sache daraus machen, aufblasen::to make a meal out of
sehr d�mlich sein::as daft as a brush
jemand tut etwas sehr doofes::someone takes the biscuit
du bist eine anstrengende person::your are a pain in the neck
extrem gl�cklich sein::be over the moon
sehr deprimiert sein::feel down in the dumps
Schulden haben::be in the red
ins Bett gehen::hit the sack
kinderleicht::kid's stuff
nichts weitersagen::stay mum
St�ckchen f�r St�ckchen::odds and ends
bereit sein f�r::be up to it
in einer unangenehmen Lage sein::be in a fix
den Mund halten::hold your tongue
unrealistisches Versprechen ::pie in the sky
ein Tropfen auf dem hei�en Stein::drop in the ocean
zu viel zu tun::enough on my plate
wilde Vermutung::shot in the dark
die Fassung verlieren::fly off the handle
aneinander vorbeireden::talking at cross purposes
die Situation erkl�ren::put you in the picture
entweder oder::you can not have your cake and eat it
Nebenkriegschaupl�tze aufmachen::going down sideroads
Spa�verderber::party puper
sehr hart arbeiten::working like a dog
