etwas verlassen, von etwas fern bleiben::absent from
besser als::better at
jemanden einer Sache für schuldig befinden::guilty of
zu spät sein für::late for
etwas leihen von jemanden::borrow from
sich auf etwas konzentrieren::concentrate on
zu etwas gratulieren::congratulate on
entscheiden über::decide on
abhängig von::depend on
sich von jemanden/etwas unterscheiden::differ from
Angst haben vor::afraid of
sich schämen für::ashamed of
sich einer Sache bewusst sein::aware of
imstande sein, fähig sein::capable of
zufrieden sein mit::satisfied with
knapp an etwas::short of
ähneln zu dem::similar to
jemanden bedauern, Mitleid haben::sorry for
entrinnen, einer Sache entkommen::escape from
bestehen auf::insist on
operieren::operate on
bewahren vor, abhalten von::prevent from
sich von etwas erholen::recover from
sich auf etwas/jemanden verlassen::rely on
austreten, zurücktreten::resign from
abhängig von::dependent on
berühmt für::famous for
voll von::full of
etwas gut können::good at
auf jemanden eifersüchtig sein::jealous of
passend für::suitable for
misstrauisch gegenüber jemanden::suspicious of
graut es vor::terrified of
schlecht im::terrible at
müde sein von, es satt haben::tired of
sich zurückziehen aus::retire from 
sich über etw./jmdn. ärgern::to be annoyed with sth./so.
stolz auf etwas sein::proud of
klar zum, ::ready for
verantwortlich für::responsible for
typisch für::typical of
aus etwas bestehen::consist of
aufgeteilt in::divided into
ohne Rücksicht auf::regardless of
egal welcher::regardless of which
zwecks, um zu::in order to
gewöhnt daran sein::accustomed to
relevant sein ::relevant to
auf etwas scharf sein::keen on
gegen jemanden eingestellt::opposed to
an etwas leiden::suffer from
erinnern an::remind of
sich auf etwas spezialisieren::specialise in
erfolg haben mit::succeed in
etwas bezahlen für::pay for
gehören zu::belong to
dagegen sein::objected to
durchsuchen, forschen nach::search for
glauben an::believe in
sich für etwas/ jemanden entschuldigen::apologize for
jemanden etwas vorwerfen::blame for
billigen, akzeptieren::approve of
hoffen auf::hope for
einer Sache wegen anklagen::accuse of
etwas verzeihen::forgive for
